NO ./ressources/textures/TECH_3G.xpm
SO ./ressources/textures/TECH_0F.xpm
WE ./ressources/textures/TECH_3D.xpm
EA ./ressources/textures/TECH_1F.xpm

F 23, 29, 23
C 35, 36, 43

       111111111111
      10000000000001
      10010010000001
 1111110000000000001
1000N10000000111111
10001000000001
 111111111111