NO ./ressources/textures/TECH_3G.xpm
SO ./ressources/textures/TECH_0F.xpm
WE ./ressources/textures/TECH_3D.xpm
EA ./ressources/textures/TECH_1F.xpm

F 23, 29, 23
C 35, 36, 43

       111111111111          111111111111   
      10000000000001        10000000000001  
      100100100000011111111100010010000001
 11111100000000000000000000000000000000001  
1000N000000000000000000000000000000111111   
100000000000011111111100000000000001        
 111111111111         1111111111111         