NO ./ressources/textures/TECH_3G.xpm
SO ./ressources/textures/TECH_0F.xpm
WE ./ressources/textures/TECH_3D.xpm
EA ./ressources/textures/TECH_1F.xpm

F 23, 29, 23
C 35, 36, 43

       111111111111          111111111111   
      10000000000001        10000000000001  
      10010010000001        10010010000001  
 1111110000000000001   1111110000000000001  
1000N00000000111111   1000000000000111111   
10000000000001        10000000000001        
 111111111111          111111111111         