NO ./ressources/textures/TECH_3G.xpm
SO ./ressources/textures/TECH_0F.xpm
WE ./ressources/textures/TECH_3D.xpm
EA ./ressources/textures/TECH_1F.xpm

F 23, 29, 23
C 35, 36, 43

                        
                        
       111111           
      10000001          
      10000001          
      100N0001          
       111111           
                        
                        