NO       ./path_north


EA  ./path_east

F   120,255,130
C 65,18,121

R     1600       1200

SO   ./path_south
WE                            ./path_west

S                  ./path_sprite





        11111
1111111110201
1000000000N01
1111111111111
