R 850 600
NO ./path_to_north_texture
SO ./path_to_south_texture
WE ./path_to_west_texture
EA ./path_to_east_texture

C 100,230,216
F 15,135,0
S ./path_to_sprite_texture

1111111
1000011
1000001
100W001
1000001
1000011
1111111
