R 425 300
F 45,255,61
C 57,210,242
S ./sprite_path
NO ./north_path
SO ./south_path
EA ./east_path
WE ./west_path

   11111111111111111111
   10000000000000000001
   10000000000000000001
   100011111111000000001
   10001      10000000001
   10001      100110000001
   10001     1001  1000001
   10001     1001  1000001
   11111     100011000001
              1000000001
              100000001
              100000001
   11111      1000N0001
   10001      100000001
   10001111111100000001
   10000000000000000001
   11111111111111111111
